NO ./textures/dungeon/dng1.xpm
SO ./textures/dungeon/dng2.xpm
WE ./textures/dungeon/dng3.xpm
EA ./textures/dungeon/dng4.xpm
F 88,0,71
C 126,201,237
           111
           101
           101
           101
           101
           101
           101
           101
           101
           101
           101
           101
           101
           101
           101
           101
           101
           101
           101
           101
           101
           101
           101
           101
 1111111111101  111111
 10100000000N011000001
 100000110001000000001
 111000110001000111111
   10001100000001
  110000001110001111
  1000000010000001
  1000000000000001
  1000000000000001
  1000000000000001
  100000000000000111111111111111
  100000000000000000000000000001
  100000000000001111111111111111
  111111111111111
C 126,201,237
