
F 88,185,71

NO ./textures/dungeon/dng1.xpm
SO ./textures/dungeon/dng2.xpm
WE ./textures/dungeon/dng3.xpm
EA ./textures/dungeon/dng4.xpm

 111111111111  1111111     111111
 111000000001111000001     100001
 100000110001000000001     111111
 111000110001000111111
   10001100000001
  110000001110001111
  1000000010000001
  1000000000100001
  1000111100100001
  1000000100000001
  100000010000000111111111111111
  1000000100000000000000W0000001
  100000000000001111111111111111
  111111111111111

  11111111111
  10000000001
  11111111111


C 126,201,237

