NO ./textures/dungeon/dng1.xpm
SO ./textures/dungeon/dng2.xpm
WE ./textures/dungeon/dng3.xpm
EA ./textures/dungeon/dng4.xpm

F 88,185,71
C 126,201,237

11111111111111W
