NO ./textures/dungeon/dng1.xpm
SO ./textures/dungeon/dng2.xpm
WE ./textures/dungeon/dng3.xpm
EA ./textures/dungeon/dng4.xpm

F 88,88,71
C 126,201,237







 11111111111111  111111
 101000000000011110001
 100000110001000000001
 111000110001000111111
   10001100000001
  1100000011100011111111111111111111111111111111111111111111111111111111
  10000000100000000000000000000000000000000000E000000001
  1000000000000001111111111111111111111111111111111111111111111111111111
  1000000000000001
  100000000000000111111111111111
  100000000100000000000000000001
  100000000000001111111111111111
  111111111111111
