NO ./textures/dungeon/dng1.xpm
SO ./textures/dungeon/dng2.xpm
WE ./textures/dungeon/dng3.xpm
EA ./textures/dungeon/dng4.xpm

F 70,70,70
C 0,43,23

        1111111111111111111111111
        1011000001111111111100001
        1011000001111000111000001
        1011010W00001000110000001
111111111011000001111000110000001
100000000011100001111111111111111
11110111111111101100011111001
11110111111111101101010010001
11000000110101101101010010001
10000000000000001101010010001
10000000000000000001010010001
1100000111010101111101111000111
11110111 1110101 101111010001
11111111 1111111 111111111111